
NO     ./path_to_the_north_texture
NOS ./path_to_the_south_texture
WE ./path_to_the_west_texture
EA ./path_to_the_east_texture
F 220.100.255
C 220.100.254


11111111111111
  1000000100111
11100111000001111111
11001111000001
10001  111101111
10001     100001
1000111111111101
1S00000000000001
111111111111111111111