
NO     ./path_to_the_north_texture
SO ./path_to_the_south_texture
WE ./path_to_the_west_texture
EA ./path_to_the_east_texture
F 220,100,0
C 220,100,0


11111111111111
1000100010011
1110001000101111111
11000000001N1
1000100001111
100010000101
100010000101
111111111111111111111