
NO     ./path_to_the_north_texture
SO ./path_to_the_south_texture
WE ./path_to_the_west_texture
EA ./path_to_the_east_texture
F 220.010.1
C 220.010.0


11111111111111
  1000000100111
11100111000001111111
11001111000001
10001  111101111
10001     100001
100011111111110111111
100000000000000000001
100000000000000000001
100000E00000000000001
100000000000000000001
111111111111111111111