
NO     ./path_to_the_north_texture.xpm
SO ./path_to_the_south_texture.xpm
WE ./path_to_the_west_texture.xpm
EA ./path_to_the_east_texture.xpm
C 0.255.255
F 218.106.24


11111111111111
  1000000100111
11100111000001111111
11001111000001
10001  111101111
10001     100001
100011111111110111111
100000000000000000001
1000000W0000100000101
111111111111111111111