
NO     ./path_to_the_north_texture.xpm
SO ./path_to_the_south_texture.xpm
WE ./path_to_the_west_texture.xpm
EA ./path_to_the_east_texture.xpm
C 0.255.255
F 218.106.24


11111111111
10000000001
10000000001
10000000001
10000000001
100000S0001
10000000001
11111111111